row: 9
col: 21
start: 0 5  
goal: 8 7
XXXXX XXXXXXXXXXXXXXX
XXXXX XXXXXXXXXXXXXXX
X     XXXXXXXXXXXXXXX
XXXXX           XX XX
XXXXXXXX X XXXX XX XX
XXXXXXXX X XXXX XX XX
XXXXXXX  XXXXXX XXXXX
XXXXX   XXXXX   XXXXX
XXXXXXX XXXXXXXXXXXXX
