row: 11
col: 33
start: 0 11  
goal: 10 19
XXXXXXXXXXX XXXXXXXXXXXXXXXXXXXXX
XX               XXXXXXXXXXXXXXXX
XXXXX XXXXXXXXXX            XXXXX
XXXXX XXXXXXXXXX XXXXXXXXXX XXXXX
XXXXX      XXXXX XXXXXXXXXX  XXXX
XXXXXXXXXX XXXXX XXXXXXXXXXX XXXX
XXXXXXXXX  XXXXX         XXX   XX
XXXX      XXXXXXXXXXXXX XXXXXXXXX
XXXX XXXXXXXXXXXXXX     XXXXXXXXX
XXXXXXXXXXXXXXXXXXX XXXXXXXXXXXXX
XXXXXXXXXXXXXXXXXXX XXXXXXXXXXXXX
